R  1920 1080
NO ./textures/wall.xpm
WE ./textures/greystone.xpm
SO ./textures/colorstone.xpm
EA ./textures/mossy.xpm
S ./textures/barrel.xpm

F 128,128,128
C 128,128,0

111111111111111111111111111111111111111111
100000002201000000000000000000000000000001
1000S0000000000000000000000000000000000001
100000000001000000000000000000000000000001
120000000021200000000000000000000000000001
120000000021200000000000000000000000000001
111110011111000000000000000000000000000001
100000000000000000000000000000000000000001
100000000000000000000000000000000000000001
100000000000000000000000000000000000000001
100000000000000000000000000000000000000001
100000000000000000000000000000000000000001
111111111111111111111111111111111111111111
