R  800 500
NO ./textures/wall.xpm
WE ./textures/wall2.xpm
SO ./textures/wall3.xpm
EA ./textures/wall4.xpm
S ./textures/sprite.xpm

F 0,0,0
C 255,255,255

111111111111111111
10000000N000000001
102020000000020201
102020000000020201
102020000000020201
102020000000020201
102020000000020201
102020000000020201
102020000000020201
102020000000020201
102020000000020201
102020000000020201
102020000000020201
102020000000020201
102020000000020201
102020000000020201
102020000000020201
102020000000020201
102020000000020201
111111111111111111
